1111111
10C0P11
1E01011
1C01001
1111111