11111111111111111111111111111111111111111111111111
11P00000110000100001000011110000CCC000110001100011
11101110C00110001100011011110110111010000100001001
1C001111011110111111111011110110111011111111111001
111111C0011C0011110C0000C00001000C0011111111111001
1C100001111111111111111111111111111111100C00111001
100011111111111111111111111111111C00111C1C00100011
11111111110000C001111111111100C0001011101111111001
1111000000011100C0000C0000000111110001101000011101
11C1100011111111111111111111111011110010C011000101
11011000111111011110001001111110111100100111101101
110010C0111111000111011100011110111110001111100001
111010001111111111110001110110101111111111111111E1
11100001111111111000110101111010110001111111111101
11110111111111111111111101111110110101111111111101
11000111111111111111111000011100010101111111111101
11011111111111111111111001011101010101111111111001
110000000C0C0000C000000011011101010100000001110011
11111111111111111111111111000001000111111100000111
11111111111111111111111111111111111111111111111111