11111111111111111111111111111111111111
11P011111111000000000CC000000000011111
11100000C00101111111111111111111011111
1111111000C0011111100001111111110000E1
11111111111111111111111111111111111111