11111111111111111111111111111111111
11P00C00N10000N00001000011110000CC1
11101110C00110001100011011110110111
1C00N1110101101111111N1011N10110111
111N11C0011C0011110C0000C00000000C1
1C100001111111111111111111111111111
1000111111111111110CN111111111111C1
11101111110000C0010N1111111100C0001
1110000000011100C0000C0000000111111
11C11000111111111111111111N11110111
11011000111111011110001001111110111
110010C0111111000111011100011110111
11101000111111111111000111011010111
11100001111111111000110101111010111
11110111111111111111111101111110111
11000111111111111111111000011100011
11011111111NCN111111111001011101011
110000000C0C0000C00000000001E101011
11111111111111111111111111000001001
11111111111111111111111111111111111