11111111111111111
100C00P0N0C00N001
100C00000N0000C01
100000E000000N001
11111111111111111